==========S=========
==========.=========
==========.=========
==========.=========
==========.=========
==========.=========
==========.=========
==========.=========
==========...=======
============.=======
=======......=======
=======.===.========
=======........=====
=======.======.=====
=======.======.=====
=======........=====
==============.=====
==============.....E
====================
====================
