=========S==========
=..................=
=========.==========
=..................=
=========.==========
=..................=
=========.==========
=..................=
=========.==========
=..................=
=========.==========
=..................=
=========.==========
=..................=
=========.==========
=..................=
=========.==========
=..................=
=========.==========
=========E==========
