=S==================
=..................=
=.================.=
=..................=
=.========.=========
=..................=
=.================.=
=..................=
==================.=
=..................=
=.================.=
=..................=
=.==================
=..................=
=.========.=========
=..................=
==================.=
=..................=
=.================.=
==================E=
