============S=======
========.===.=======
=====....===.=======
=====.==..........==
====..==============
====.===============
==.......===========
========.=====...===
========.===...=...=
========.....===.===
================.===
=====.==.===.....===
=====.==.===.=======
=====..........=====
============.......E
===============.====
======.===.====.====
======.===......====
======.....=========
====================
