=S==================
=..................=
==================.=
=..................=
=.==================
=..................=
==================.=
=..................=
=.==================
=..................=
==================.=
=..................=
=.==================
=..................=
==================.=
=..................=
=.==================
=..................=
==================.=
==================E=
