=S==================
=..................=
=..................=
=..................=
=..................=
=..................=
=..................=
=..................=
=..................=
=..................=
=..................=
=..................=
=..................=
=..................=
=..................=
=..................=
=..................=
=..................=
=..................=
=E==================
