====================
====================
====================
====================
====================
====================
====================
====================
========.....=======
S........===.......E
========.....=======
====================
====================
====================
====================
====================
====================
====================
====================
====================
